------------- !-
|     |        |
|  |--|  |  |--|
|        |  |  |
|--|--|--|  |  |
|           |  |
|  |  |--|  |  |
|  |     |     |
|  |--|--|--|  |
|  |        |  |
|  |  |--|  |  |
|     |     |  |
|  |--|  |--|  |
|     |  |     |
|--|--|@ |--|--|