,-----------.-----------.--------------------.-----------.-----------------.
|           |           |                    |           |                 |
|  ,-----   |  ,-----.  |  .  ,-----------.  `--------   |  ,--.  .  ,--   |
|  |        |  |     |  |  |  |           |              |  |  |  |  |     |
|  |  ,-----'  |  .  |  |  `--"--------.  "  ,-----------'  "  |  `--"-----:
|  |  |        |  |  |  |              |     |                 |           |
|  |  |   --.  |  `--:  |  ,--------.  |  ,--:  ,--.-----------"--------   |
|  |  |     |  |     |  |  |        |  |  | !|  |  |                       |
|  |  `-----'  |   --'  |  `-----   |  |  |  |  |  |  ,--------.--------.  |
|  |           |        |           |  |  |  |  |  |  |        |        |  |
|  `-----------"-----.  `-----------:  |  "  |  |  |  |  ,--   |  ,--.  |  |
|                    |              |  |     |  |  |  |  |     |  |  |  |  |
|  ,--------------.  :-----------.  |  `-----:  |  |  |  `-----'  "  |  |  |
|  |              |  |           |  |        |  |  |  |              |  |  |
|  |  ,--------.  |  |  ,-----.  |  :-----   |  |  |  `--------------:  "  |
|  |  |        |  |  |  |     |  |  |        |  |  |                 |     |
|  |  `-----   |  |  |  |  .  |  |  |  ,-----'  |  `--------------.  `-----:
|  |           |  |  |  |  |  |  |  |  |        |                 |        |
|  `-----------'  |  |  |  |  |  |  |  |  ,-----'  ,-----------.  :--.  .  |
|                 |  |  |  |  |  |  |  |  |        |           |  |  |  |  |
:-----------------'  |  |  |  |  |  |  |  |  ,--.  |   -----.  |  |  |  |  |
|                    |  |  |  |  |  |  |  |  |  |  |        |  |  |  |  |  |
|  ,--------   ,-----:  |  |  "  |  |  |  |  "  |  |  ,-----'  |  "  |  |  |
|  |           |     |  |  |     |  |  |  |     |  |  |        |     |  |  |
|  `-----------'  .  :--'  `-----'  "  |  :--.  |  :--'  ,--   `--.  |  |  |
|                 |  |                 |  |  |  |  |     |        |  |  |  |
|  ,-----.--------'  |   -----.   --.  |  |  "  |  |   --"--------'  |  |  |
|  |     |           |        |     |  |  |     |  |                 |  |  |
|  `--   |  ,-----.  :--------"-----"--'  |   --:  :-----------------'  |  |
|        |  |     |  |                    |     |  |                    |  |
:-----.  |  |   --:  |  ,-----------.-----"-----'  |  ,--.--------------'  |
|     |  |  |     |  |  |           |              |  |  |                 |
|  .  |  |  |  .  "  |  :--------   `--   ,-----.  |  |  |  ,-----------.--:
|  |  |  |  |  |     |  |                 |     |  |  |  |  |           |  |
|  `--:  |  `--"-----'  "  .  ,--   ,-----'   --'  |  |  "  |  .   --.  "  |
|     |  |                 |  |     |              |  |     |  |     |     |
|  .  |  :-----.-----------"--"-----"--.   --------:  :--.  `--"--.  `-----:
|  |  |  |     |                       |           |  |  |        |        |
|  |  |  |  .  |  ,-----------------.  `-----------'  |  `--.--.  |  ,--.  |
|  |  |  |  |  |  |                 |                 |     |  |  |  |  |  |
|  `--'  |  `--:  |  ,--------------"--------------.--'  .  |  |  |  |  |  |
|        |     |  |  |                             |     |  |  |  |  |  |  |
|  ,-----'  .  |  |  |  ,--------.-----.  ,-----.  |  .  |  |  |  |  |  |  |
|  |        |  |  |  |  |        |     |  |     |  |  |  |  |  |  |  |  |  |
|  `--------:  |  |  |  |  .  .  `--   |  |   --'  |  |  |  "  |  |  |  |  |
|           |  |  |  |  |  |  |        |  |        |  |  |     |  |  |  |  |
:--------.  |  |  |  "  `--'  :--------:  |   -----:  |  `-----'  |  "  |  |
|        |  |  |  |           |        |  |        |  |           |     |  |
|   -----'  "  |  `-----------'   --.  |  `--------'  `-----.   --"-----'  |
|              |                    |  |                    |              |
`--------------"--------------------'@ `--------------------"--------------'