@  ########################################################################################
      #     #           #     #  #  #           #     #  #        #     #     #           #
#  #######  #  ####  #  #  #  #  #  #  #  ##########  #  ####  #  #  ####  #  #  #  #  #  #
#           #  #     #     #  #        #     #  #     #        #  #        #     #  #  #  #
####  #############  #  #######  ####  #######  ####  #  #  #  #######  ####  #######  ####
#  #        #     #  #     #        #           #        #  #     #     #        #        #
#  #  ####  ####  #  ####  #  #######  #  #######  #######  ####  #  #  ################  #
#     #     #     #     #           #  #        #  #  #        #     #     #        #     #
####  ##########  #############  ####  #  ####  #  #  ####  ####  #######  #######  ####  #
#  #                 #        #  #     #  #  #  #  #     #  #        #  #     #  #     #  #
#  #############  ####  #  ####  ####  ####  ####  #  #######  #  #  #  #######  ####  #  #
#  #  #        #  #     #           #  #           #     #  #  #  #  #     #        #     #
#  #  ####  #  #  #  #######  #######  #  #  #  ####  #  #  ##########  #  #######  ####  #
#  #        #           #     #  #  #  #  #  #  #     #              #  #  #     #     #  #
#  #######  #######  #  ####  #  #  #  #  #######  ####  #  #  #  #  #  #  #  ####  ####  #
#        #  #        #     #        #  #     #     #  #  #  #  #  #     #           #     #
#  ####  #  #  #  ####  ##########  ################  #  ##########  #  #  ####  #######  #
#  #        #  #  #           #        #              #  #  #  #     #  #  #  #  #  #     #
#######  #######  ##########  #  ################  #  ####  #  ##########  #  ####  ####  #
#     #        #     #        #     #        #     #           #        #        #        #
####  ##########  #############  ####  ####  ##########  ####  #  ####  ####  #  #######  #
#        #  #  #     #     #              #  #  #  #     #        #  #        #           #
#  ####  #  #  ####  ####  ##########  ####  #  #  #  ####  #######  #######  #  #  #######
#  #     #                 #     #        #     #     #  #  #        #  #     #  #  #  #  #
#  ####  #  #  ####  ####  ####  #  #######  ####  #  #  #  #######  #  #######  #  #  #  #
#     #     #     #     #  #     #        #     #  #     #        #  #           #     #  #
#  #  #  #  #  ####  ####  #  #  #  #############  #  #############  #  ####  ####  ####  #
#  #  #  #  #     #     #     #  #        #  #     #     #     #        #     #  #        #
#############  #  #######  ##########  ####  ##########  #  #  ####  ####  #  #  #  #  #  #
#  #  #     #  #  #        #        #           #  #     #  #        #  #  #  #     #  #  #
#  #  #  #######  #  #  ####  #############  ####  #  #  #  #  ####  #  #  ##########  #  #
#  #        #     #  #  #  #        #  #     #  #     #  #  #  #     #        #  #     #  #
#  ####  #  #  #  ####  #  ####  ####  ####  #  #############  #  #  ####  ####  ####  ####
#     #  #  #  #     #  #  #  #  #           #     #  #     #  #  #  #     #     #        #
####  #  #######  #######  #  #  #############  ####  #  ####  #######  #  #  #######  #  #
#        #     #  #        #  #  #           #     #     #  #  #     #  #  #        #  #  #
#######  #  #  #  ####  ####  #  ####  ####  #  ####  ####  ####  ##########  #  ####  ####
#           #                       #  #  #     #        #  #     #     #     #     #  #  #
#  ####  ####  #########################  #  #  #  ####  #  ####  #  #  ##########  #  #  #
#     #  #  #  #           #        #        #     #           #     #  #  #     #     #  #
####  ####  #  #  #  ##########  #  #  #######  ####  ####  #  #  #  ####  ####  ####  #  #
#  #        #     #     #        #  #        #     #     #  #  #  #  #  #        #  #     #
#  #  #  #  #  ####  #######  ################  #######  #  ####  #  #  #  ####  #  #  ####
#  #  #  #  #     #  #                    #  #  #        #  #     #           #     #  #  #
#  #  ################  ####  ####  #######  #  ####  #######  ####  ##########  #  #  #  #
#     #  #     #  #  #  #     #  #        #        #  #     #     #  #  #        #     #  #
#  #  #  ####  #  #  ####  ####  ####  #  ####  #  #  #  ##########  #  #############  #  #
#  #  #                 #        #     #        #  #  #        #           #        #  #  #
#  ##########  ##########  ####  #######  #######  #######  ####  #  ####  #  ####  ####  #
#     #  #           #        #  #  #     #        #  #     #  #  #     #  #  #           #
#  ####  ##########  #  #  #  ####  #######  #  ####  ####  #  #  #  #  #############  ####
#  #     #     #        #  #     #     #     #     #              #  #     #              #
#  #  #  ####  #######  ##########  #  #  #######  ####  #######  ################  #  ####
#     #        #  #  #              #  #        #  #     #  #     #     #  #        #     #
#  #  #######  #  #  #  #  #  #  #  #######  #  ####  ####  #  #  #  #  #  #  ####  ####  #
#  #        #           #  #  #  #        #  #  #     #  #  #  #     #     #     #     #  #
#######  #  #  #  #############  #############  #######  #  ####  #######  #  #  #######  #
#        #  #  #     #  #     #  #  #     #     #        #     #  #     #     #        #  #
#  ####  #############  #  ####  #  #  #  #  #######  #  ####  #  ####  #  #  #######  #  #
#     #        #                 #     #              #           #        #        #  #  #
########################################################################################  !